########....########
#..................#
#..................#
#...####....####...#
#...#..........#...#
#...#..........#...#
#...#..........#...#
#...#..........#...#
....................
....................
....................
....................
#...#..........#...#
#...#..........#...#
#...#..........#...#
#...#..........#...#
#...####....####...#
#..................#
#..................#
########....#########