########....########
#..................#
#..................#
#..##############..#
#..................#
#..................#
#..#.....##.....#..#
#..#.....##.....#..#
...#............#...
...#............#...
...#............#...
...#............#...
#..#.....##.....#..#
#..#.....##.....#..#
#..................#
#..................#
#..##############..#
#..................#
#..................#
########....#########